R 2000 1280
NO ./sprite/mur.xpm
SO ./sprite/mur.xpm
WE ./sprite/mur1.xpm
EA ./sprite/mur3.xpm
S ./sprite/2.xpm
F 220,100,2
C 225,30,2



                                   11111
                                      1111
             11111111111                1111
               101                    111111
               1N1                      11111111111
               111                  11111111111111
        
		   11111111111111111111111111111111111111111111
           10000000000000000000100000000000000000000001
           1000000001100000001111111111100000000000001
           11110000001100001111111000000000000000000011             11111111111111111111
           10000001100000002200001111111111111111111101          111100000000000000001
           1000000110002200000000011111111111111111101          101111111111111111111
           1000000011000000220000011111100000000000001          101
           1111111111111100000000011111111111111110001          101
                        10000111111111111111111111111111111111111001
             11111      111111110000000000000000000001100000000000001
             10001        1111111111111111111111111111111111111111111
         1111111111111111111111111111111111111111111111111111








