1111111111111111111                 
1001000000000000001                 
10001000C0000000001                 
1001100000000000001           
10011000000000000011111111111111111111
10000000000000000000000000000000000001
1111000000000P00001000000000000000000111111111
110000000E000000001000000000000000000000000001
1111111111111111111111111111111111111111111111
