R 1000 1000
NO ./sprite/mur.xpm
SO ./sprite/mur.xpm
WE ./sprite/mur1.xpm
EA ./sprite/mur3.xpm
S ./sprite/2.xpm
F 220,200,120
C 225,60,230





           111111111111111111111
           10000020N000000020001
           100000000000000021001
           100000000000000000001
           1111111110111111111111
           1000000000000020000011
           10002000011000000011    
           11111111011111111111    
           111111110111111111111
           100000000000000000001
           100000002000020000001
           100000000000000000001
           1111111110111111111111
           1000200000000020000011
           10000000011000000011    
           11111111111111111111    








