R 1500 1700
NO ./sprite/Blob.xpm
SO ./sprite/Blob.xpm
WE ./sprite/Blob.xpm
EA ./sprite/Blob.xpm
S ./sprite/Blob.xpm
F 125,0,0
C 90,0,0





           111111111111111111111
           10000020W222222220001
           122222222222222221001                  11111111111
           122222222222222222221                  10000000001
           122222222222222222221                  10000000001
           122222222222222222211                  10000000001
           10002000011000200011111111111111111111110000000001
           11111111011111111111000000000000000000000000000001
           11111111011111111110000000000000000000000000000001
           100000000000000000000111111111111111111111111111111111111111111111111111111
           100000002000020000001111111111111111111111111111111111100000000000000000001
           100000000000000000001                                  11111111111111111111
           1111111110111111111111
           1000200000000020000011
           10000000011000000011
           11111111111111111111








